144 16
2 2 2 2 2 2 2 2 2 2 2 2 2 2 2 2
2 2 2 1 1 1 1 1 1 1 1 1 1 2 2 2
2 2 2 1 2 2 2 1 2 2 2 2 1 2 2 2
2 2 2 1 2 2 2 1 2 2 2 2 1 2 2 2
2 2 2 1 2 2 2 1 2 2 2 2 1 2 2 2
2 2 2 1 2 2 2 1 2 2 2 2 1 2 2 2
2 2 2 1 2 2 2 1 2 2 2 2 8 2 2 2
2 2 2 7 1 1 1 1 1 1 1 1 1 2 2 2
2 2 2 2 2 2 2 2 2 2 2 2 2 2 2 2