21 21
222222222222222222222
2S1111111111111111112
212222222222222222212
212222222222222222212
212222222222222222212
212222222222222222212
212222222222222222212
212222222222222222212
212222222222222222212
212222222222222222212
212222222222222222212
212222222222222222212
212222222222222222212
212222222222222222212
212222222222222222212
212222222222222222212
212222222222222222212
212222222222222222212
212222222222222222212
2111111111111111111F2
222222222222222222222